1111111111111111111111111
111C111C101C1111111111111
1C0P01C001C0C0E0C0C111111
1C0C101C0C011C101C0C01111
1C0C0C0C0C0C00C01C0C01111
1110111C0C0C10C011C010111
100C0C0C0C0C01C0011C0C011
111C1100C0C11C011C0C0C011
100C0C0001C001C0C0C0C0C01
100011C0C011110011C0C0C01
100101C0C001C0C00011C0C01
100101C011111C011C011C011
100101C0C000C011C011C0C01
100101C111111C11C011C0C01
100100C00000000C0C0C0C011
1111111111111111111111111