1111111111111111111
1P00000000001000001
1000000000001000001
1000000000001000001
100000000C000000001
1000000000001000001
1000000000001000001
1000000000001000001
10000000000010000E1
1111111111111111111
