11111111111111111111111111111
1P00000C0000000000000000C0001
1000000000000C00000C000000001
1000000C000000000000000000001
100000000000C00000C00000000E1
11111111111111111111111111111