111111111
1P0001C01
111100001
100001001
100C010E1
111111111
