1111111111111111111111
1P0000000000C0000000C1
1011110111111111111111
101C000100000000C10001
10111101C1111111010101
1000C101000000C1010101
1111110101111111010101
1C00000100C0000001C101
1111110111111111011101
1000C10000000C00000001
1011110111111111111111
100000C0000000000C0001
1111111111111111111101
1E000000000C0000000001
1111111111111111111111
