1111111111111111111111111
1C0P01C001C0C0E0C0C110001
1C0C101C0C011C101C0C01001
1C0C0C0C0C0C00C01C0C00101
1110111C0C0C10C011C010001
100C0C0C0C0C01C0011C0C001
111C1100C0C11C011C0C0C001
100C0C0001C001C0C0C0C0C01
100011C0C011110011C0C0C01
100101C0C001C0C00011C0C01
100101C011111C011C011C001
100101C0C000C011C011C0C01
100101C111111C11C011C0C01
100100C00000000C0C0C0C001
1111111111111111111111111