1111111111111111111111111
110P0110001000C1011101001
1100101010110100C01010001
110010001000C001010101001
1110111001C10001101010001
1000000010100100001010001
1110111C0101C001101010001
1000100C0001C001010000001
100011C0C0111C00110101001
1000101C0C001010000110101
1000101C01111101011011001
1000101C0C00001001011C001
1000101C11111111011011C01
1000000C000000010001001E1
1111111111111111111111111
