1111111111111111111111111111111111111111
1C10000000000000000000000000000000000001
1P10111111101111101111101111111111111101
10101C000010000C10000C10000000C1C0000101
1010111110101111101111111111111111110101
101000000010000C10000C10000000C10000C101
1010101111101111101111101111111101111101
101010000C10000C10000C10000000C1C0000101
1010111111101111101111101111111111110101
10101C000000000C10000C10000000C10000C101
1010111111111111111111101111111101111101
101000000000000C10000C10000000C1C0000101
1010111111111111101111101111111111110101
10101C000000000C10000C10000000C10000C101
1010111111101111101111101111111101111101
10101C000000000C10000C10000000C1C0000101
1010111111111101101111101111111111110101
101000000000000000000000000000000000C101
1010111111111111111111111111111111111101
1C0000000000000000000000000000000000C1E1
1111111111111111111111111111111111111111