11111111111111111111
1CP0100010E0C0000101
1C1000111C1000111C01
1C0C00000C010C000C01
100111C00010C011C011
100C00001C001011C011
111C11001C11C011C011
100C00001C001011C011
100011C011110011C011
100101C001C00011C011
100101C011111011C011
100101C00000C011C011
100101C11111111C0101
100100C00000000C0101
10011111111111111101
11111111111111111111
