11111111111111
1P000000000001
10000000000001
10000000000001
10000000000001
1000000C000001
10000000000001
10000000000001
10000000000001
100000000000E1
11111111111111
