1111111111111111
1C01000001000101
1010011111010011
1P0000C00C000CE1
1010000011010001
1010010000010011
1C0000C00C0C0001
1011000011011111
101C011100010001
1C0000C00C0C0001
1011000011011111
100C011111110001
1C0111C00C0C0001
1011000011111111
100C011100011111
1111111111111111